NO textures/test/north.xpm
SO textures/test/south.xpm
WE textures/test/west.xpm
EA textures/test/east.xpm
F 220,100,0
C 225,30,0
        1111111111111111111111111
        1000000000110000000000001
        1011000001110000000000001
        1001000000000000000000001
111111111011000001110000000000001
100000000011000001111011111111111
11110111111111011100000010001
11110111111111011101010010001
11000000110101011100000000001
10000000000000011000000010001
1000N000000000001101010010001
110000011101010111110111100001
111101111010101111111010000001
111111111111111111111111111111
