011111111111111111
111110CP1111111111
111111111111111110