111111111111111111
111110CP11111E1111
111111111111111111